,year,month,day,supply,load,remain
0,2019,1,2,30047,28148,1899
1,2019,1,3,30343,28452,1891
2,2019,1,4,30301,28490,1811
3,2019,1,5,27957,26054,1903
4,2019,1,6,26950,24617,2333
5,2019,1,7,30336,28536,1800
6,2019,1,8,30562,28719,1843
7,2019,1,9,30595,28641,1954
8,2019,1,10,30853,29006,1847
9,2019,1,11,30682,28798,1884
10,2019,1,12,28402,25905,2497
11,2019,1,13,27027,24629,2398
12,2019,1,14,30093,28348,1745
13,2019,1,15,30731,28887,1844
14,2019,1,16,30498,28649,1849
15,2019,1,17,30328,28395,1933
16,2019,1,18,29691,27756,1935
17,2019,1,19,28431,26477,1954
18,2019,1,20,27138,24539,2599
19,2019,1,21,29654,27739,1915
20,2019,1,22,30061,28140,1921
21,2019,1,23,29776,27838,1938
22,2019,1,24,29735,27863,1872
23,2019,1,25,29202,27296,1906
24,2019,1,26,27817,25282,2535
25,2019,1,27,26506,24414,2092
26,2019,1,28,29363,27557,1806
27,2019,1,29,29690,27858,1832
28,2019,1,30,29570,27760,1810
29,2019,1,31,29071,27181,1890
30,2019,2,1,26857,24709,2148
31,2019,2,2,25623,23382,2241
32,2019,2,3,24953,22915,2038
33,2019,2,4,22777,20214,2563
34,2019,2,5,22325,19992,2333
35,2019,2,6,22258,19936,2322
36,2019,2,7,23045,20938,2107
37,2019,2,8,24696,21581,3115
38,2019,2,9,25572,22436,3136
39,2019,2,10,26259,23236,3023
40,2019,2,11,28942,26667,2275
41,2019,2,12,29628,27768,1860
42,2019,2,13,29614,27699,1915
43,2019,2,14,30193,28250,1943
44,2019,2,15,30221,28262,1959
45,2019,2,16,27858,25432,2426
46,2019,2,17,27016,24343,2673
47,2019,2,18,30407,28645,1762
48,2019,2,19,30767,28876,1891
49,2019,2,20,30916,29078,1838
50,2019,2,21,30725,28912,1813
51,2019,2,22,30290,28420,1870
52,2019,2,23,28452,26723,1729
53,2019,2,24,26464,24694,1770
54,2019,2,25,29838,28084,1754
55,2019,2,26,30208,28390,1818
56,2019,2,27,29916,28013,1903
57,2019,2,28,27902,25472,2430
58,2019,3,1,27060,24689,2371
59,2019,3,2,26567,24734,1833
60,2019,3,3,26326,24102,2224
61,2019,3,4,29583,27688,1895
62,2019,3,5,30195,28241,1954
63,2019,3,6,29954,28032,1922
64,2019,3,7,30015,28147,1868
65,2019,3,8,29767,27951,1816
66,2019,3,9,28061,25870,2191
67,2019,3,10,26624,24801,1823
68,2019,3,11,29524,27730,1794
69,2019,3,12,29815,27936,1879
70,2019,3,13,30068,28145,1923
71,2019,3,14,30197,28417,1780
72,2019,3,15,29685,27757,1928
73,2019,3,16,27836,25318,2518
74,2019,3,17,26971,24681,2290
75,2019,3,18,30093,28338,1755
76,2019,3,19,30687,28882,1805
77,2019,3,20,31489,29645,1844
78,2019,3,21,32310,30343,1967
79,2019,3,22,31959,29618,2341
80,2019,3,23,27349,25265,2084
81,2019,3,24,26671,24812,1859
82,2019,3,25,30388,28535,1853
83,2019,3,26,30643,28756,1887
84,2019,3,27,31073,29140,1933
85,2019,3,28,31985,30093,1892
86,2019,3,29,31728,29673,2055
87,2019,3,30,27965,25810,2155
88,2019,3,31,26763,24466,2297
89,2019,4,1,29772,27842,1930
90,2019,4,2,30275,28359,1915
91,2019,4,3,30387,28483,1905
92,2019,4,4,28003,25663,2340
93,2019,4,5,26414,24542,1872
94,2019,4,6,26649,24966,1683
95,2019,4,7,27018,25240,1778
96,2019,4,8,32368,30399,1969
97,2019,4,9,33496,31532,1964
98,2019,4,10,33863,31709,2154
99,2019,4,11,32620,30541,2079
100,2019,4,12,31053,29035,2018
101,2019,4,13,28206,26446,1760
102,2019,4,14,28065,25537,2528
103,2019,4,15,30735,28749,1986
104,2019,4,16,30894,29017,1877
105,2019,4,17,31615,29565,2050
106,2019,4,18,32338,30335,2003
107,2019,4,19,32668,30748,1920
108,2019,4,20,28787,26910,1877
109,2019,4,21,28604,26306,2298
110,2019,4,22,33948,31955,1993
111,2019,4,23,35207,33181,2026
112,2019,4,24,35266,33263,2003
113,2019,4,25,35424,33134,2290
114,2019,4,26,34916,32664,2252
115,2019,4,27,29369,27376,1993
116,2019,4,28,28688,26948,1740
117,2019,4,29,35058,32847,2211
118,2019,4,30,35309,33099,2210
119,2019,5,1,29919,26826,3093
120,2019,5,2,31373,28690,2683
121,2019,5,3,31631,28315,3316
122,2019,5,4,28938,25819,3119
123,2019,5,5,27591,25336,2255
124,2019,5,6,31019,28615,2404
125,2019,5,7,31081,28472,2609
126,2019,5,8,31108,28968,2140
127,2019,5,9,31441,29229,2212
128,2019,5,10,32179,29571,2608
129,2019,5,11,29413,26576,2837
130,2019,5,12,29193,26484,2709
131,2019,5,13,34446,32135,2311
132,2019,5,14,35275,33144,2131
133,2019,5,15,35149,32896,2253
134,2019,5,16,35739,33307,2432
135,2019,5,17,34862,32316,2546
136,2019,5,18,32114,29523,2591
137,2019,5,19,31104,28977,2127
138,2019,5,20,35560,32213,3347
139,2019,5,21,33865,29978,3887
140,2019,5,22,34704,30150,4554
141,2019,5,23,35142,30430,4712
142,2019,5,24,35123,31548,3575
143,2019,5,25,31794,27810,3984
144,2019,5,26,31694,27905,3789
145,2019,5,27,35227,32521,2706
146,2019,5,28,35411,32242,3169
147,2019,5,29,36224,30319,5905
148,2019,5,30,36483,32116,4367
149,2019,5,31,37486,32971,4515
150,2019,6,1,32902,28860,4042
151,2019,6,2,32488,28856,3632
152,2019,6,3,37498,32958,4540
153,2019,6,4,36955,32409,4546
154,2019,6,5,37945,33916,4029
155,2019,6,6,38674,34889,3785
156,2019,6,7,34770,30068,4702
157,2019,6,8,32858,29548,3310
158,2019,6,9,33490,29408,4082
159,2019,6,10,37502,33355,4147
160,2019,6,11,36341,32126,4215
161,2019,6,12,36513,31095,5418
162,2019,6,13,35273,31680,3593
163,2019,6,14,35772,30877,4895
164,2019,6,15,33122,27686,5436
165,2019,6,16,32635,27673,4962
166,2019,6,17,37468,33703,3765
167,2019,6,18,37996,34739,3257
168,2019,6,19,39258,35601,3657
169,2019,6,20,39662,35959,3703
170,2019,6,21,40008,35928,4080
171,2019,6,22,35113,30923,4190
172,2019,6,23,33049,28305,4744
173,2019,6,24,37104,31688,5416
174,2019,6,25,36804,33290,3514
175,2019,6,26,36928,32816,4112
176,2019,6,27,37640,33465,4175
177,2019,6,28,38530,34963,3567
178,2019,6,29,34155,30553,3602
179,2019,6,30,33522,30083,3439
180,2019,7,1,38849,35215,3634
181,2019,7,2,39935,35052,4883
182,2019,7,3,38706,33953,4753
183,2019,7,4,39052,34157,4895
184,2019,7,5,39567,33853,5714
185,2019,7,6,34449,30014,4435
186,2019,7,7,34278,29965,4313
187,2019,7,8,39621,35166,4455
188,2019,7,9,39052,34886,4166
189,2019,7,10,39164,35267,3897
190,2019,7,11,38719,34564,4155
191,2019,7,12,39970,35638,4332
192,2019,7,13,36491,31353,5138
193,2019,7,14,34198,30941,3257
194,2019,7,15,39898,36261,3637
195,2019,7,16,40150,36926,3224
196,2019,7,17,41153,37383,3770
197,2019,7,18,40002,35922,4080
198,2019,7,19,39994,35484,4510
199,2019,7,20,36836,30618,6218
200,2019,7,21,34994,29604,5390
201,2019,7,22,40246,34488,5758
202,2019,7,23,39770,35004,4766
203,2019,7,24,40609,35571,5038
204,2019,7,25,40591,35955,4636
205,2019,7,26,40420,36523,3897
206,2019,7,27,36553,31207,5346
207,2019,7,28,35368,29654,5714
208,2019,7,29,40478,35554,4924
209,2019,7,30,40714,36647,4067
210,2019,7,31,40536,36807,3729
211,2019,8,1,40524,36482,4042
212,2019,8,2,40810,35775,5035
213,2019,8,3,36920,31045,5875
214,2019,8,4,35151,31333,3818
215,2019,8,5,40649,36721,3928
216,2019,8,6,41157,36386,4771
217,2019,8,7,40786,36067,4719
218,2019,8,8,40648,36331,4317
219,2019,8,9,37717,30740,6977
220,2019,8,10,36049,31478,4571
221,2019,8,11,35251,31064,4187
222,2019,8,12,40272,34479,5793
223,2019,8,13,38658,33906,4752
224,2019,8,14,40164,36100,4064
225,2019,8,15,40630,34275,6355
226,2019,8,16,40427,34379,6048
227,2019,8,17,37079,30424,6655
228,2019,8,18,34759,28616,6143
229,2019,8,19,39330,32954,6376
230,2019,8,20,39597,33328,6269
231,2019,8,21,39972,33542,6430
232,2019,8,22,39807,34983,4824
233,2019,8,23,40025,35157,4868
234,2019,8,24,35969,28996,6973
235,2019,8,25,34452,28990,5462
236,2019,8,26,40403,35049,5354
237,2019,8,27,40285,35593,4692
238,2019,8,28,40601,36507,4094
239,2019,8,29,40424,36368,4056
240,2019,8,30,40228,34613,5615
241,2019,8,31,35403,30636,4767
242,2019,9,1,34611,29629,4982
243,2019,9,2,39989,35383,4606
244,2019,9,3,40050,35469,4581
245,2019,9,4,39136,33717,5419
246,2019,9,5,39153,33277,5876
247,2019,9,6,39285,34200,5085
248,2019,9,7,34982,30088,4894
249,2019,9,8,33239,29047,4192
250,2019,9,9,39318,34357,4961
251,2019,9,10,38812,34664,4148
252,2019,9,11,39916,35341,4575
253,2019,9,12,39889,35264,4625
254,2019,9,13,34199,29375,4824
255,2019,9,14,33070,28676,4394
256,2019,9,15,33578,28191,5387
257,2019,9,16,39253,33228,6025
258,2019,9,17,38936,32961,5975
259,2019,9,18,38470,32428,6042
260,2019,9,19,38401,31508,6893
261,2019,9,20,36939,30594,6345
262,2019,9,21,32072,26460,5612
263,2019,9,22,31257,25836,5421
264,2019,9,23,36566,29947,6619
265,2019,9,24,36722,30106,6616
266,2019,9,25,36388,30709,5679
267,2019,9,26,36821,31162,5659
268,2019,9,27,37499,31255,6244
269,2019,9,28,33013,28161,4852
270,2019,9,29,32241,27926,4315
271,2019,9,30,36162,28505,7657
272,2019,10,1,36449,31917,4532
273,2019,10,2,37393,33316,4077
274,2019,10,3,37506,33699,3807
275,2019,10,4,38091,33670,4421
276,2019,10,5,37012,32451,4561
277,2019,10,6,31819,28030,3789
278,2019,10,7,36591,32889,3702
279,2019,10,8,37289,32938,4351
280,2019,10,9,37046,32345,4701
281,2019,10,10,32222,27817,4405
282,2019,10,11,31667,27177,4490
283,2019,10,12,31704,26962,4742
284,2019,10,13,31796,26364,5432
285,2019,10,14,35975,30884,5091
286,2019,10,15,35615,30530,5085
287,2019,10,16,34313,30329,3984
288,2019,10,17,34761,30179,4582
289,2019,10,18,34982,30172,4810
290,2019,10,19,31218,26430,4788
291,2019,10,20,29653,25233,4420
292,2019,10,21,33493,29219,4274
293,2019,10,22,33840,30037,3803
294,2019,10,23,34065,30286,3779
295,2019,10,24,34172,30343,3829
296,2019,10,25,34251,30131,4120
297,2019,10,26,29599,26498,3101
298,2019,10,27,28487,25725,2762
299,2019,10,28,34260,30207,4053
300,2019,10,29,34240,29624,4616
301,2019,10,30,33380,29714,3666
302,2019,10,31,33719,30080,3639
303,2019,11,1,34261,30331,3930
304,2019,11,2,30083,26705,3378
305,2019,11,3,29165,25745,3420
306,2019,11,4,32647,29192,3455
307,2019,11,5,33016,29247,3769
308,2019,11,6,32766,29422,3344
309,2019,11,7,33353,29601,3752
310,2019,11,8,33641,28900,4741
311,2019,11,9,29609,25900,3709
312,2019,11,10,27748,24716,3032
313,2019,11,11,32227,28620,3607
314,2019,11,12,32897,29305,3592
315,2019,11,13,32660,29360,3300
316,2019,11,14,32776,28953,3823
317,2019,11,15,31914,28764,3150
318,2019,11,16,29275,26075,3200
319,2019,11,17,27956,25366,2590
320,2019,11,18,32343,29306,3037
321,2019,11,19,32080,28743,3337
322,2019,11,20,32282,28935,3347
323,2019,11,21,32516,29520,2996
324,2019,11,22,32470,29500,2970
325,2019,11,23,29491,26796,2695
326,2019,11,24,28774,25584,3190
327,2019,11,25,32309,29340,2969
328,2019,11,26,32597,29285,3312
329,2019,11,27,32877,29312,3565
330,2019,11,28,32028,28610,3418
331,2019,11,29,31864,28472,3392
332,2019,11,30,28859,25855,3004
333,2019,12,1,28261,24836,3425
334,2019,12,2,31398,27936,3462
335,2019,12,3,31307,28157,3150
336,2019,12,4,31527,28474,3053
337,2019,12,5,31728,28706,3022
338,2019,12,6,31977,28563,3414
339,2019,12,7,28725,25824,2901
340,2019,12,8,27706,24750,2956
341,2019,12,9,31412,28207,3205
342,2019,12,10,31602,28456,3146
343,2019,12,11,31599,28397,3202
344,2019,12,12,31420,28422,2998
345,2019,12,13,31524,28370,3154
346,2019,12,14,28711,25676,3035
347,2019,12,15,27529,24717,2812
348,2019,12,16,31890,28851,3039
349,2019,12,17,32423,29234,3189
350,2019,12,18,32339,29085,3254
351,2019,12,19,32059,28952,3107
352,2019,12,20,31727,28581,3146
353,2019,12,21,29167,26352,2815
354,2019,12,22,27862,25115,2747
355,2019,12,23,32117,28787,3330
356,2019,12,24,32280,28996,3284
357,2019,12,25,32571,28965,3606
358,2019,12,26,32218,28955,3263
359,2019,12,27,31073,27867,3206
360,2019,12,28,28502,25349,3153
361,2019,12,29,27888,24989,2899
362,2019,12,30,31134,27991,3143
363,2019,12,31,30472,27364,3108
364,2020,1,1,28125,25335,2790
365,2020,1,2,31303,28223,3080
366,2020,1,3,31676,28292,3384
367,2020,1,4,29219,25583,3636
368,2020,1,5,27456,24761,2695
369,2020,1,6,31653,28644,3009
370,2020,1,7,32248,29144,3104
371,2020,1,8,31779,28544,3235
372,2020,1,9,31861,28730,3131
373,2020,1,10,31774,28476,3298
374,2020,1,11,29193,25342,3851
375,2020,1,12,27933,24842,3091
376,2020,1,13,31804,28647,3157
377,2020,1,14,32213,28801,3412
378,2020,1,15,31817,28431,3386
379,2020,1,16,31719,28714,3005
380,2020,1,17,31585,28186,3399
381,2020,1,18,29228,26068,3160
382,2020,1,19,28656,25322,3334
383,2020,1,20,31153,27970,3183
384,2020,1,21,30776,27517,3259
385,2020,1,22,29635,25748,3887
386,2020,1,23,26875,23531,3344
387,2020,1,24,25026,21543,3483
388,2020,1,25,24573,21022,3551
389,2020,1,26,24702,21174,3528
390,2020,1,27,25414,21710,3704
391,2020,1,28,26470,22817,3653
392,2020,1,29,27288,23984,3304
393,2020,1,30,29314,26323,2991
394,2020,1,31,30075,26714,3361
395,2020,2,1,29101,25211,3890
396,2020,2,2,28063,24816,3247
397,2020,2,3,32048,27960,4088
398,2020,2,4,31745,28443,3302
399,2020,2,5,32040,28397,3643
400,2020,2,6,31829,28482,3347
401,2020,2,7,32042,28275,3767
402,2020,2,8,29290,25630,3660
403,2020,2,9,28234,25150,3084
404,2020,2,10,31429,28283,3146
405,2020,2,11,31882,28663,3219
406,2020,2,12,31881,28533,3348
407,2020,2,13,32340,29094,3246
408,2020,2,14,32322,29199,3123
409,2020,2,15,30766,27770,2996
410,2020,2,16,29047,25062,3985
411,2020,2,17,32044,28300,3744
412,2020,2,18,32675,28426,4249
413,2020,2,19,31938,28374,3564
414,2020,2,20,31745,28613,3132
415,2020,2,21,31665,28527,3138
416,2020,2,22,29721,26047,3674
417,2020,2,23,28803,25064,3739
418,2020,2,24,31837,28827,3010
419,2020,2,25,32320,29196,3124
420,2020,2,26,32634,29467,3167
421,2020,2,27,32621,28368,4253
422,2020,2,28,29642,26356,3286
423,2020,2,29,28483,25677,2806
424,2020,3,1,28307,24986,3321
425,2020,3,2,31852,28557,3295
426,2020,3,3,32289,29183,3106
427,2020,3,4,32616,28858,3758
428,2020,3,5,32126,28608,3518
429,2020,3,6,31748,28569,3179
430,2020,3,7,29894,26182,3712
431,2020,3,8,28936,25557,3379
432,2020,3,9,32862,29653,3209
433,2020,3,10,32522,28591,3931
434,2020,3,11,31786,28531,3255
435,2020,3,12,32350,29348,3002
436,2020,3,13,32263,29165,3098
437,2020,3,14,29628,25802,3826
438,2020,3,15,28330,24837,3493
439,2020,3,16,32804,27984,4820
440,2020,3,17,32896,28753,4143
441,2020,3,18,33271,29118,4153
442,2020,3,19,32474,29389,3085
443,2020,3,20,32730,29030,3700
444,2020,3,21,29655,26635,3020
445,2020,3,22,29174,26088,3086
446,2020,3,23,33143,29372,3771
447,2020,3,24,33595,29470,4125
448,2020,3,25,33615,30038,3577
449,2020,3,26,34029,30842,3187
450,2020,3,27,34524,31260,3264
451,2020,3,28,29959,25893,4066
452,2020,3,29,28641,25152,3489
453,2020,3,30,32224,28716,3508
454,2020,3,31,32484,29162,3322
455,2020,4,1,32373,28278,4095
456,2020,4,2,29551,25443,4108
457,2020,4,3,28869,25120,3749
458,2020,4,4,28652,24238,4414
459,2020,4,5,28596,24347,4249
460,2020,4,6,32300,28246,4054
461,2020,4,7,32145,28108,4037
462,2020,4,8,31610,28246,3364
463,2020,4,9,31963,28285,3678
464,2020,4,10,33120,28470,4650
465,2020,4,11,28931,25752,3179
466,2020,4,12,27413,24604,2809
467,2020,4,13,30942,27614,3328
468,2020,4,14,31447,27884,3563
469,2020,4,15,31679,28182,3497
470,2020,4,16,31672,28528,3144
471,2020,4,17,32599,28990,3609
472,2020,4,18,30146,26657,3489
473,2020,4,19,29546,26518,3028
474,2020,4,20,34077,29986,4091
475,2020,4,21,34362,29986,4376
476,2020,4,22,32626,28595,4031
477,2020,4,23,31998,28050,3948
478,2020,4,24,31626,27678,3948
479,2020,4,25,28825,25659,3166
480,2020,4,26,28230,25110,3120
481,2020,4,27,32516,28706,3810
482,2020,4,28,33642,28955,4687
483,2020,4,29,32878,29532,3346
484,2020,4,30,34477,29613,4864
485,2020,5,1,30298,26786,3512
486,2020,5,2,29887,26473,3414
487,2020,5,3,29782,26815,2967
488,2020,5,4,35816,32340,3476
489,2020,5,5,36721,33321,3400
490,2020,5,6,36390,32964,3426
491,2020,5,7,36246,32510,3736
492,2020,5,8,37205,33791,3414
493,2020,5,9,33523,29700,3823
494,2020,5,10,32439,29424,3015
495,2020,5,11,36553,33203,3350
496,2020,5,12,35739,31973,3766
497,2020,5,13,36463,32264,4199
498,2020,5,14,36824,33442,3382
499,2020,5,15,37409,33787,3622
500,2020,5,16,33975,30028,3947
501,2020,5,17,32935,28694,4241
502,2020,5,18,36888,32803,4085
503,2020,5,19,35962,31336,4626
504,2020,5,20,36458,31507,4951
505,2020,5,21,35554,31571,3983
506,2020,5,22,34567,30892,3675
507,2020,5,23,30959,26898,4061
508,2020,5,24,31194,26905,4289
509,2020,5,25,36380,32438,3942
510,2020,5,26,36459,32896,3563
511,2020,5,27,36376,31444,4932
512,2020,5,28,36780,31519,5261
513,2020,5,29,36642,32544,4098
514,2020,5,30,32699,28513,4186
515,2020,5,31,32206,28776,3430
516,2020,6,1,37293,33660,3633
517,2020,6,2,38452,34381,4071
518,2020,6,3,38653,34490,4163
519,2020,6,4,38689,34935,3754
520,2020,6,5,38543,34861,3682
521,2020,6,6,34992,30752,4240
522,2020,6,7,32656,28121,4535
523,2020,6,8,36941,32361,4580
524,2020,6,9,36875,32360,4515
525,2020,6,10,38137,33770,4367
526,2020,6,11,38206,34220,3986
527,2020,6,12,38596,35010,3586
528,2020,6,13,35316,31552,3764
529,2020,6,14,34393,29821,4572
530,2020,6,15,40129,35096,5033
531,2020,6,16,39696,35674,4022
532,2020,6,17,40135,36160,3975
533,2020,6,18,40155,35964,4191
534,2020,6,19,40202,36340,3862
535,2020,6,20,38988,35313,3675
536,2020,6,21,35108,31624,3484
537,2020,6,22,40476,36627,3849
538,2020,6,23,40615,36847,3768
539,2020,6,24,41256,37170,4086
540,2020,6,25,35231,31852,3379
541,2020,6,26,34259,30352,3907
542,2020,6,27,34086,30466,3620
543,2020,6,28,34519,31107,3412
544,2020,6,29,40364,36351,4013
545,2020,6,30,41328,36682,4646
546,2020,7,1,40360,36331,4029
547,2020,7,2,40305,35847,4458
548,2020,7,3,39929,35798,4131
549,2020,7,4,36211,31924,4287
550,2020,7,5,34694,31219,3475
551,2020,7,6,40904,35888,5016
552,2020,7,7,40936,36326,4610
553,2020,7,8,41421,37106,4315
554,2020,7,9,41053,36686,4367
555,2020,7,10,41209,36830,4379
556,2020,7,11,36606,32935,3671
557,2020,7,12,35741,32223,3518
558,2020,7,13,41502,37528,3974
559,2020,7,14,41714,37790,3924
560,2020,7,15,40965,36755,4210
561,2020,7,16,40988,35903,5085
562,2020,7,17,41138,36882,4256
563,2020,7,18,37514,33193,4321
564,2020,7,19,35959,31831,4128
565,2020,7,20,41789,37521,4268
566,2020,7,21,41958,36825,5133
567,2020,7,22,41633,37367,4266
568,2020,7,23,41868,38020,3848
569,2020,7,24,41686,37557,4129
570,2020,7,25,37535,32838,4697
571,2020,7,26,35266,30548,4718
572,2020,7,27,41325,36760,4565
573,2020,7,28,40863,36333,4530
574,2020,7,29,41198,36353,4845
575,2020,7,30,41052,35592,5460
576,2020,7,31,40438,36300,4138
577,2020,8,1,36803,32682,4121
578,2020,8,2,34564,30754,3810
579,2020,8,3,38616,33718,4898
580,2020,8,4,38389,34036,4353
581,2020,8,5,39761,35374,4387
582,2020,8,6,40446,36593,3853
583,2020,8,7,40542,36682,3860
584,2020,8,8,36232,32361,3871
585,2020,8,9,34353,31166,3187
586,2020,8,10,40137,36411,3726
587,2020,8,11,39551,35167,4384
588,2020,8,12,40807,36537,4270
589,2020,8,13,40952,36301,4651
590,2020,8,14,40963,35941,5022
591,2020,8,15,36145,31204,4941
592,2020,8,16,34343,29721,4622
593,2020,8,17,40123,35538,4585
594,2020,8,18,40515,36279,4236
595,2020,8,19,40865,36996,3869
596,2020,8,20,41202,36818,4384
597,2020,8,21,40685,36823,3862
598,2020,8,22,34383,30985,3398
599,2020,8,23,33542,30245,3297
600,2020,8,24,40178,36483,3695
601,2020,8,25,40885,37073,3812
602,2020,8,26,39623,35827,3796
603,2020,8,27,39652,35107,4545
604,2020,8,28,39394,35122,4272
605,2020,8,29,35312,31138,4174
606,2020,8,30,34763,30677,4086
607,2020,8,31,39916,35197,4719
608,2020,9,1,39898,35420,4478
609,2020,9,2,40360,36492,3868
610,2020,9,3,40285,35474,4811
611,2020,9,4,40850,35980,4870
612,2020,9,5,34680,30758,3922
613,2020,9,6,31794,27921,3873
614,2020,9,7,38299,33937,4362
615,2020,9,8,39289,35134,4155
616,2020,9,9,39546,35370,4176
617,2020,9,10,39693,35438,4255
618,2020,9,11,39682,35598,4084
619,2020,9,12,34694,31311,3383
620,2020,9,13,33054,30030,3024
621,2020,9,14,39358,35640,3718
622,2020,9,15,40037,36312,3725
623,2020,9,16,40254,36521,3733
624,2020,9,17,40570,36846,3724
625,2020,9,18,40622,36893,3729
626,2020,9,19,35803,32486,3317
627,2020,9,20,33402,29517,3885
628,2020,9,21,38959,34397,4562
629,2020,9,22,39362,34237,5125
630,2020,9,23,39461,34689,4772
631,2020,9,24,38959,33525,5434
632,2020,9,25,37286,32012,5274
633,2020,9,26,35642,31095,4547
634,2020,9,27,31297,26808,4489
635,2020,9,28,35668,31113,4555
636,2020,9,29,36005,31746,4259
637,2020,9,30,36008,30723,5285
638,2020,10,1,31043,26398,4645
639,2020,10,2,30535,27075,3460
640,2020,10,3,30966,27548,3418
641,2020,10,4,31872,28281,3591
642,2020,10,5,37047,32508,4539
643,2020,10,6,36139,31900,4239
644,2020,10,7,35407,31307,4100
645,2020,10,8,35531,30813,4718
646,2020,10,9,31793,27483,4310
647,2020,10,10,30682,27387,3295
648,2020,10,11,30519,27431,3088
649,2020,10,12,36424,33063,3361
650,2020,10,13,36854,33389,3465
651,2020,10,14,36790,32798,3992
652,2020,10,15,36608,32682,3926
653,2020,10,16,36679,32878,3801
654,2020,10,17,32108,28021,4087
655,2020,10,18,30516,26570,3946
656,2020,10,19,35551,31046,4505
657,2020,10,20,35876,31632,4244
658,2020,10,21,35676,32367,3309
659,2020,10,22,35543,31202,4341
660,2020,10,23,33701,29698,4003
661,2020,10,24,30683,26791,3892
662,2020,10,25,30151,26126,4025
663,2020,10,26,34595,31092,3503
664,2020,10,27,35071,31669,3402
665,2020,10,28,35429,31959,3470
666,2020,10,29,34978,31271,3707
667,2020,10,30,34479,30264,4215
668,2020,10,31,30482,26763,3719
669,2020,11,1,29696,26127,3569
670,2020,11,2,33953,30430,3523
671,2020,11,3,33163,29974,3189
672,2020,11,4,33339,29788,3551
673,2020,11,5,33663,30344,3319
674,2020,11,6,35055,31792,3263
675,2020,11,7,31405,28206,3199
676,2020,11,8,29547,25619,3928
677,2020,11,9,33448,29368,4080
678,2020,11,10,33402,29812,3590
679,2020,11,11,33320,29612,3708
680,2020,11,12,33593,30403,3190
681,2020,11,13,33559,30186,3373
682,2020,11,14,30510,27146,3364
683,2020,11,15,29565,26102,3463
684,2020,11,16,34111,30964,3147
685,2020,11,17,34607,31405,3202
686,2020,11,18,35177,31816,3361
687,2020,11,19,35383,32069,3314
688,2020,11,20,35666,32023,3643
689,2020,11,21,31603,28675,2928
690,2020,11,22,29650,26885,2765
691,2020,11,23,33976,30832,3144
692,2020,11,24,34084,30950,3134
693,2020,11,25,34797,31491,3306
694,2020,11,26,34573,31429,3144
695,2020,11,27,33669,30174,3495
696,2020,11,28,29814,26837,2977
697,2020,11,29,28529,25242,3287
698,2020,11,30,32437,29117,3320
699,2020,12,1,32814,29577,3237
700,2020,12,2,32582,29532,3050
701,2020,12,3,32478,29310,3168
702,2020,12,4,32466,29382,3084
703,2020,12,5,30262,26644,3618
704,2020,12,6,28297,25606,2691
705,2020,12,7,32832,29726,3106
706,2020,12,8,33028,29864,3164
707,2020,12,9,33229,30135,3094
708,2020,12,10,33283,30197,3086
709,2020,12,11,33050,29921,3129
710,2020,12,12,29946,26664,3282
711,2020,12,13,28289,25459,2830
712,2020,12,14,32639,29617,3022
713,2020,12,15,32714,29702,3012
714,2020,12,16,32818,29798,3020
715,2020,12,17,32878,29878,3000
716,2020,12,18,32849,29802,3047
717,2020,12,19,29790,26743,3047
718,2020,12,20,29274,25658,3616
719,2020,12,21,32722,29650,3072
720,2020,12,22,33107,29908,3199
721,2020,12,23,33388,30312,3076
722,2020,12,24,33402,29857,3545
723,2020,12,25,32717,29299,3418
724,2020,12,26,29798,26732,3066
725,2020,12,27,28846,25977,2869
726,2020,12,28,32626,29491,3135
727,2020,12,29,33114,30020,3094
728,2020,12,30,32211,29093,3118
729,2020,12,31,31598,28444,3154
730,2021,1,1,28487,25720,2767
731,2021,1,2,28421,25485,2936
732,2021,1,3,28513,25476,3037
733,2021,1,4,32766,29734,3032
734,2021,1,5,33117,30050,3067
735,2021,1,6,33429,30327,3102
736,2021,1,7,33602,30500,3102
737,2021,1,8,33518,30412,3106
738,2021,1,9,31269,28068,3201
739,2021,1,10,30161,27255,2906
740,2021,1,11,33772,30679,3093
741,2021,1,12,33749,30633,3116
742,2021,1,13,33108,29994,3114
743,2021,1,14,33153,30021,3132
744,2021,1,15,32864,29555,3309
745,2021,1,16,30167,27121,3046
746,2021,1,17,29746,26712,3034
747,2021,1,18,33095,29938,3157
748,2021,1,19,33148,29990,3158
749,2021,1,20,33134,29984,3150
750,2021,1,21,33359,30285,3074
751,2021,1,22,33192,30095,3097
752,2021,1,23,30421,27218,3203
753,2021,1,24,28790,25717,3073
754,2021,1,25,33063,29794,3269
755,2021,1,26,33152,29933,3219
756,2021,1,27,32652,29588,3064
757,2021,1,28,32843,29557,3286
758,2021,1,29,32472,29269,3203
759,2021,1,30,30109,26662,3447
760,2021,1,31,28364,25458,2906
